3 2985
5
FLOOR 57
364 524 16 16      1536 688   16
364 524 16 16      1536 704   16
364 460 16 16      0 208   16
364 460 16 16      0 224   16
364 460 16 16      2543 208   35
364 460 16 16      2543 224   35
364 524 16 16      0 448   80
364 524 16 16      0 464   80
364 524 16 16      1328 448   37
364 524 16 16      1328 464   37
364 524 16 16      1952 448   2
364 524 16 16      1952 464   2
364 524 16 16      2016 448   12
364 524 16 16      2016 464   12
364 524 16 16      2320 448   8
364 524 16 16      2320 464   8
364 524 16 16      2560 448   32
364 524 16 16      2560 464   32
380 540 16 16      272 432   1
380 540 16 16      304 432   1
380 540 16 16      304 416   1
380 540 16 16      336 400   1
380 540 16 16      336 432   1
380 540 16 16      336 416   1
380 540 16 16      368 400   1
380 540 16 16      368 432   1
380 540 16 16      368 416   1
380 540 16 16      368 384   1
380 540 16 16      400 400   1
380 540 16 16      400 432   1
380 540 16 16      400 416   1
380 540 16 16      400 384   1
380 540 16 16      432 400   1
380 540 16 16      432 432   1
380 540 16 16      432 416   1
380 540 16 16      496 400   1
380 540 16 16      496 432   1
380 540 16 16      496 416   1
380 540 16 16      528 432   1
380 540 16 16      528 416   1
380 540 16 16      2128 432   5
380 540 16 16      2144 416   4
380 540 16 16      2160 400   3
380 540 16 16      2176 384   2
380 476 16 16      2623 192   9
380 476 16 16      2639 176   8
380 476 16 16      2655 160   7
380 476 16 16      2671 144   6
380 476 16 16      2687 128   5
380 476 16 16      2703 112   4
380 476 16 16      2719 96   3
380 476 16 16      2735 80   2
380 476 16 16      2895 192   1
215 0 16 16      192 144   2
215 0 16 16      192 160   2
215 0 16 16      192 176   2
215 0 16 16      192 192   2

H_SEWER 3
85 230 16 32       102 230 16 32    160 176     32      1   35 280    0 240       0
249 230 16 32       266 230 16 32    1744 656     32      1   1848 415    1840 240       1
249 230 16 32       266 230 16 32    2656 368     32      1   2599 176    2543 0       1

SEWER 4
283 196 32 16       283 213 32 16    1648 400     48     1   1560 512     1536 480
283 196 32 16       283 213 32 16    1744 384     64     0
283 196 32 16       283 213 32 16    1840 416     32     0
119 196 32 16       119 213 32 16    2591 176     32     0

FLAG 1
388 405 17 17       143 247 2 16    2887 48     144

COIN 34
3 397 97 10 14 414 97 10 14 431 97 10 14     6 379 129 8 16 349 129 8 16 359 129 8 16 369 129 8 16 359 129 8 16 349 129 8 16    643 370
3 397 97 10 14 414 97 10 14 431 97 10 14     6 379 129 8 16 349 129 8 16 359 129 8 16 369 129 8 16 359 129 8 16 349 129 8 16    659 322
3 397 97 10 14 414 97 10 14 431 97 10 14     6 379 129 8 16 349 129 8 16 359 129 8 16 369 129 8 16 359 129 8 16 349 129 8 16    675 322
3 397 97 10 14 414 97 10 14 431 97 10 14     6 379 129 8 16 349 129 8 16 359 129 8 16 369 129 8 16 359 129 8 16 349 129 8 16    691 322
3 397 97 10 14 414 97 10 14 431 97 10 14     6 379 129 8 16 349 129 8 16 359 129 8 16 369 129 8 16 359 129 8 16 349 129 8 16    707 322
3 397 97 10 14 414 97 10 14 431 97 10 14     6 379 129 8 16 349 129 8 16 359 129 8 16 369 129 8 16 359 129 8 16 349 129 8 16    723 370
3 397 97 10 14 414 97 10 14 431 97 10 14     6 379 129 8 16 349 129 8 16 359 129 8 16 369 129 8 16 359 129 8 16 349 129 8 16    931 370
3 397 97 10 14 414 97 10 14 431 97 10 14     6 379 129 8 16 349 129 8 16 359 129 8 16 369 129 8 16 359 129 8 16 349 129 8 16    947 370
3 397 97 10 14 414 97 10 14 431 97 10 14     6 379 129 8 16 349 129 8 16 359 129 8 16 369 129 8 16 359 129 8 16 349 129 8 16    963 370
3 397 97 10 14 414 97 10 14 431 97 10 14     6 379 129 8 16 349 129 8 16 359 129 8 16 369 129 8 16 359 129 8 16 349 129 8 16    979 370
3 397 97 10 14 414 97 10 14 431 97 10 14     6 379 129 8 16 349 129 8 16 359 129 8 16 369 129 8 16 359 129 8 16 349 129 8 16    1091 370
3 397 97 10 14 414 97 10 14 431 97 10 14     6 379 129 8 16 349 129 8 16 359 129 8 16 369 129 8 16 359 129 8 16 349 129 8 16    1347 322
3 397 97 10 14 414 97 10 14 431 97 10 14     6 379 129 8 16 349 129 8 16 359 129 8 16 369 129 8 16 359 129 8 16 349 129 8 16    1363 322
3 397 97 10 14 414 97 10 14 431 97 10 14     6 379 129 8 16 349 129 8 16 359 129 8 16 369 129 8 16 359 129 8 16 349 129 8 16    1379 322
3 397 97 10 14 414 97 10 14 431 97 10 14     6 379 129 8 16 349 129 8 16 359 129 8 16 369 129 8 16 359 129 8 16 349 129 8 16    1395 322
3 397 97 10 14 414 97 10 14 431 97 10 14     6 379 129 8 16 349 129 8 16 359 129 8 16 369 129 8 16 359 129 8 16 349 129 8 16    1411 322
3 397 97 10 14 414 97 10 14 431 97 10 14     6 379 129 8 16 349 129 8 16 359 129 8 16 369 129 8 16 359 129 8 16 349 129 8 16    1427 322
3 397 97 10 14 414 97 10 14 431 97 10 14     6 379 129 8 16 349 129 8 16 359 129 8 16 369 129 8 16 359 129 8 16 349 129 8 16    1587 674
3 397 97 10 14 414 97 10 14 431 97 10 14     6 379 129 8 16 349 129 8 16 359 129 8 16 369 129 8 16 359 129 8 16 349 129 8 16    1603 674
3 397 97 10 14 414 97 10 14 431 97 10 14     6 379 129 8 16 349 129 8 16 359 129 8 16 369 129 8 16 359 129 8 16 349 129 8 16    1619 674
3 397 97 10 14 414 97 10 14 431 97 10 14     6 379 129 8 16 349 129 8 16 359 129 8 16 369 129 8 16 359 129 8 16 349 129 8 16    1635 674
3 397 97 10 14 414 97 10 14 431 97 10 14     6 379 129 8 16 349 129 8 16 359 129 8 16 369 129 8 16 359 129 8 16 349 129 8 16    1651 674
3 397 97 10 14 414 97 10 14 431 97 10 14     6 379 129 8 16 349 129 8 16 359 129 8 16 369 129 8 16 359 129 8 16 349 129 8 16    1667 674
3 397 97 10 14 414 97 10 14 431 97 10 14     6 379 129 8 16 349 129 8 16 359 129 8 16 369 129 8 16 359 129 8 16 349 129 8 16    1683 674
3 397 97 10 14 414 97 10 14 431 97 10 14     6 379 129 8 16 349 129 8 16 359 129 8 16 369 129 8 16 359 129 8 16 349 129 8 16    1699 674
3 397 97 10 14 414 97 10 14 431 97 10 14     6 379 129 8 16 349 129 8 16 359 129 8 16 369 129 8 16 359 129 8 16 349 129 8 16    1715 674
3 397 97 10 14 414 97 10 14 431 97 10 14     6 379 129 8 16 349 129 8 16 359 129 8 16 369 129 8 16 359 129 8 16 349 129 8 16    1603 610
3 397 97 10 14 414 97 10 14 431 97 10 14     6 379 129 8 16 349 129 8 16 359 129 8 16 369 129 8 16 359 129 8 16 349 129 8 16    1619 610
3 397 97 10 14 414 97 10 14 431 97 10 14     6 379 129 8 16 349 129 8 16 359 129 8 16 369 129 8 16 359 129 8 16 349 129 8 16    1635 610
3 397 97 10 14 414 97 10 14 431 97 10 14     6 379 129 8 16 349 129 8 16 359 129 8 16 369 129 8 16 359 129 8 16 349 129 8 16    1651 610
3 397 97 10 14 414 97 10 14 431 97 10 14     6 379 129 8 16 349 129 8 16 359 129 8 16 369 129 8 16 359 129 8 16 349 129 8 16    1667 610
3 397 97 10 14 414 97 10 14 431 97 10 14     6 379 129 8 16 349 129 8 16 359 129 8 16 369 129 8 16 359 129 8 16 349 129 8 16    1683 610
3 397 97 10 14 414 97 10 14 431 97 10 14     6 379 129 8 16 349 129 8 16 359 129 8 16 369 129 8 16 359 129 8 16 349 129 8 16    1699 610
3 397 97 10 14 414 97 10 14 431 97 10 14     6 379 129 8 16 349 129 8 16 359 129 8 16 369 129 8 16 359 129 8 16 349 129 8 16    1715 610