1 2512
5
FLOOR 30
364 460 16 16      0 208   16
364 460 16 16      0 224   16
364 460 16 16      2064 208   35
364 460 16 16      2064 224   35
215 0 16 16      288 192   4
215 0 16 16      384 144   8
215 0 16 16      416 80   5
215 0 16 16      512 192   3
215 0 16 16      560 128   5
215 0 16 16      640 64   7
215 0 16 16      800 208   4
215 0 16 16      960 80   4
215 0 16 16      944 208   5
215 0 16 16      1040 208   5
215 0 16 16      1120 144   3
215 0 16 16      1216 96   6
215 0 16 16      1568 176   4
215 0 16 16      1664 112   8
215 0 16 16      1808 208   3
215 0 16 16      1856 144   4
215 0 16 16      1952 144   4
215 0 16 16      2208 192   6
215 0 16 16      2208 176   6
215 0 16 16      2208 160   6
215 0 16 16      2208 144   6
215 0 16 16      2240 128   4
215 0 16 16      2240 112   4
215 0 16 16      2272 96   2
215 0 16 16      2272 80   2
215 0 16 16      2432 192   1

FLAG 1
388 405 17 17       143 247 2 16    2424 48     144

COIN 23
3 301 97 10 14 318 97 10 14 335 97 10 14     6 379 129 8 16 349 129 8 16 359 129 8 16 369 129 8 16 359 129 8 16 349 129 8 16    435 66
3 301 97 10 14 318 97 10 14 335 97 10 14     6 379 129 8 16 349 129 8 16 359 129 8 16 369 129 8 16 359 129 8 16 349 129 8 16    451 66
3 301 97 10 14 318 97 10 14 335 97 10 14     6 379 129 8 16 349 129 8 16 359 129 8 16 369 129 8 16 359 129 8 16 349 129 8 16    467 66
3 301 97 10 14 318 97 10 14 335 97 10 14     6 379 129 8 16 349 129 8 16 359 129 8 16 369 129 8 16 359 129 8 16 349 129 8 16    531 178
3 301 97 10 14 318 97 10 14 335 97 10 14     6 379 129 8 16 349 129 8 16 359 129 8 16 369 129 8 16 359 129 8 16 349 129 8 16    595 34
3 301 97 10 14 318 97 10 14 335 97 10 14     6 379 129 8 16 349 129 8 16 359 129 8 16 369 129 8 16 359 129 8 16 349 129 8 16    611 34
3 301 97 10 14 318 97 10 14 335 97 10 14     6 379 129 8 16 349 129 8 16 359 129 8 16 369 129 8 16 359 129 8 16 349 129 8 16    803 98
3 301 97 10 14 318 97 10 14 335 97 10 14     6 379 129 8 16 349 129 8 16 359 129 8 16 369 129 8 16 359 129 8 16 349 129 8 16    819 98
3 301 97 10 14 318 97 10 14 335 97 10 14     6 379 129 8 16 349 129 8 16 359 129 8 16 369 129 8 16 359 129 8 16 349 129 8 16    963 66
3 301 97 10 14 318 97 10 14 335 97 10 14     6 379 129 8 16 349 129 8 16 359 129 8 16 369 129 8 16 359 129 8 16 349 129 8 16    979 66
3 301 97 10 14 318 97 10 14 335 97 10 14     6 379 129 8 16 349 129 8 16 359 129 8 16 369 129 8 16 359 129 8 16 349 129 8 16    995 66
3 301 97 10 14 318 97 10 14 335 97 10 14     6 379 129 8 16 349 129 8 16 359 129 8 16 369 129 8 16 359 129 8 16 349 129 8 16    1011 66
3 301 97 10 14 318 97 10 14 335 97 10 14     6 379 129 8 16 349 129 8 16 359 129 8 16 369 129 8 16 359 129 8 16 349 129 8 16    1363 82
3 301 97 10 14 318 97 10 14 335 97 10 14     6 379 129 8 16 349 129 8 16 359 129 8 16 369 129 8 16 359 129 8 16 349 129 8 16    1379 82
3 301 97 10 14 318 97 10 14 335 97 10 14     6 379 129 8 16 349 129 8 16 359 129 8 16 369 129 8 16 359 129 8 16 349 129 8 16    1491 66
3 301 97 10 14 318 97 10 14 335 97 10 14     6 379 129 8 16 349 129 8 16 359 129 8 16 369 129 8 16 359 129 8 16 349 129 8 16    1507 66
3 301 97 10 14 318 97 10 14 335 97 10 14     6 379 129 8 16 349 129 8 16 359 129 8 16 369 129 8 16 359 129 8 16 349 129 8 16    1554 66
3 301 97 10 14 318 97 10 14 335 97 10 14     6 379 129 8 16 349 129 8 16 359 129 8 16 369 129 8 16 359 129 8 16 349 129 8 16    1570 66
3 301 97 10 14 318 97 10 14 335 97 10 14     6 379 129 8 16 349 129 8 16 359 129 8 16 369 129 8 16 359 129 8 16 349 129 8 16    1811 194
3 301 97 10 14 318 97 10 14 335 97 10 14     6 379 129 8 16 349 129 8 16 359 129 8 16 369 129 8 16 359 129 8 16 349 129 8 16    1827 194
3 301 97 10 14 318 97 10 14 335 97 10 14     6 379 129 8 16 349 129 8 16 359 129 8 16 369 129 8 16 359 129 8 16 349 129 8 16    1843 194
3 301 97 10 14 318 97 10 14 335 97 10 14     6 379 129 8 16 349 129 8 16 359 129 8 16 369 129 8 16 359 129 8 16 349 129 8 16    1923 82
3 301 97 10 14 318 97 10 14 335 97 10 14     6 379 129 8 16 349 129 8 16 359 129 8 16 369 129 8 16 359 129 8 16 349 129 8 16    1939 82

LIFT 4
414 409 16 8    48      880 97    880 90    880 212    1
414 409 16 8    48      1376 129    1317 129    1395 129    1
414 409 16 8    48      1504 145    1395 145    1502 145    1
414 409 16 8    48      2096 97    2012 97    2104 97    1

QUESTION 1
3 298 78 16 16 315 78 16 16 332 78 16 16     349 78 16 16       944 160      1 POWER