2
BRICK 3
17 16 16 16     120 75 8 8      320 144
17 16 16 16     120 75 8 8      352 144
17 16 16 16     120 75 8 8      384 144
FLOOR 2
0 16 16 16      0 208   69
0 16 16 16      0 224   69
COIN 2
3 301 97 10 14 318 97 10 14 335 97 10 14     6 379 129 8 16 349 129 8 16 359 129 8 16 369 129 8 16 359 129 8 16 349 129 8 16    233 194
3 301 97 10 14 318 97 10 14 335 97 10 14     6 379 129 8 16 349 129 8 16 359 129 8 16 369 129 8 16 359 129 8 16 349 129 8 16    323 130
QUESTION 1
3 298 78 16 16 315 78 16 16 332 78 16 16     349 78 16 16       256 144