2 3265
7
BRICK 28
380 460 16 16     120 75 8 8      320 144
380 460 16 16     120 75 8 8      352 144
380 460 16 16     120 75 8 8      384 144
380 460 16 16     120 75 8 8      1232 144
380 460 16 16     120 75 8 8      1264 144
380 460 16 16     120 75 8 8      1280 80
380 460 16 16     120 75 8 8      1296 80
380 460 16 16     120 75 8 8      1312 80
380 460 16 16     120 75 8 8      1328 80
380 460 16 16     120 75 8 8      1344 80
380 460 16 16     120 75 8 8      1360 80
380 460 16 16     120 75 8 8      1376 80
380 460 16 16     120 75 8 8      1392 80
380 460 16 16     120 75 8 8      1456 80
380 460 16 16     120 75 8 8      1472 80
380 460 16 16     120 75 8 8      1488 80
380 460 16 16     120 75 8 8      1600 144
380 460 16 16     120 75 8 8      1888 144
380 460 16 16     120 75 8 8      1936 80
380 460 16 16     120 75 8 8      1952 80
380 460 16 16     120 75 8 8      1968 80
380 460 16 16     120 75 8 8      2048 80
380 460 16 16     120 75 8 8      2096 80
380 460 16 16     120 75 8 8      2064 144
380 460 16 16     120 75 8 8      2080 144
380 460 16 16     120 75 8 8      2688 144
380 460 16 16     120 75 8 8      2704 144
380 460 16 16     120 75 8 8      2736 144
FLOOR 61
364 460 16 16      0 208   69
364 460 16 16      0 224   69
364 460 16 16      1136 208    15
364 460 16 16      1136 224    15
364 460 16 16      1424 208    64
364 460 16 16      1424 224    64
364 460 16 16      2480 208    56
364 460 16 16      2480 224    56
380 476 16 16      2144 192    4
380 476 16 16      2160 176    3
380 476 16 16      2176 160    2
380 476 16 16      2192 144    1
380 476 16 16      2240 144    1
380 476 16 16      2240 160    2
380 476 16 16      2240 176    3
380 476 16 16      2240 192    4
380 476 16 16      2368 192    5
380 476 16 16      2384 176    4
380 476 16 16      2400 160    3
380 476 16 16      2416 144    2
380 476 16 16      2480 144    1
380 476 16 16      2480 160    2
380 476 16 16      2480 176    3
380 476 16 16      2480 192    4
380 476 16 16      2896 192    9
380 476 16 16      2912 176    8
380 476 16 16      2928 160    7
380 476 16 16      2944 144    6
380 476 16 16      2960 128    5
380 476 16 16      2976 112    4
380 476 16 16      2992 96    3
380 476 16 16      3008 80    2
380 476 16 16      3168 192    1
147 16 16 16      768 448    18
147 16 16 16      768 464    18
181 16 16 16      768 272    1
181 16 16 16      768 288    1
181 16 16 16      768 304    1
181 16 16 16      768 320    1
181 16 16 16      768 336    1
181 16 16 16      768 352    1
181 16 16 16      768 368    1
181 16 16 16      768 384    1
181 16 16 16      768 400    1
181 16 16 16      768 416    1
181 16 16 16      768 432    1
181 16 16 16      832 400    7
181 16 16 16      832 416    7
181 16 16 16      832 432    7
181 16 16 16      832 272    7
200 0 16 16      1008 272    1
200 0 16 16      1008 288    1
200 0 16 16      1008 304    1
200 0 16 16      1008 320    1
200 0 16 16      1008 336    1
200 0 16 16      1008 352    1
200 0 16 16      1008 368    1
200 0 16 16      1008 384    1
200 0 16 16      1008 400    1
200 0 16 16      1008 416    1
200 0 16 16      1008 432    1
COIN 21
3 301 97 10 14 318 97 10 14 335 97 10 14     6 379 129 8 16 349 129 8 16 359 129 8 16 369 129 8 16 359 129 8 16 349 129 8 16    233 194
3 301 97 10 14 318 97 10 14 335 97 10 14     6 379 129 8 16 349 129 8 16 359 129 8 16 369 129 8 16 359 129 8 16 349 129 8 16    323 130
3 397 97 10 14 414 97 10 14 431 97 10 14     6 379 129 8 16 349 129 8 16 359 129 8 16 369 129 8 16 359 129 8 16 349 129 8 16    851 322
3 397 97 10 14 414 97 10 14 431 97 10 14     6 379 129 8 16 349 129 8 16 359 129 8 16 369 129 8 16 359 129 8 16 349 129 8 16    867 322
3 397 97 10 14 414 97 10 14 431 97 10 14     6 379 129 8 16 349 129 8 16 359 129 8 16 369 129 8 16 359 129 8 16 349 129 8 16    883 322
3 397 97 10 14 414 97 10 14 431 97 10 14     6 379 129 8 16 349 129 8 16 359 129 8 16 369 129 8 16 359 129 8 16 349 129 8 16    899 322
3 397 97 10 14 414 97 10 14 431 97 10 14     6 379 129 8 16 349 129 8 16 359 129 8 16 369 129 8 16 359 129 8 16 349 129 8 16    915 322
3 397 97 10 14 414 97 10 14 431 97 10 14     6 379 129 8 16 349 129 8 16 359 129 8 16 369 129 8 16 359 129 8 16 349 129 8 16    835 354
3 397 97 10 14 414 97 10 14 431 97 10 14     6 379 129 8 16 349 129 8 16 359 129 8 16 369 129 8 16 359 129 8 16 349 129 8 16    851 354
3 397 97 10 14 414 97 10 14 431 97 10 14     6 379 129 8 16 349 129 8 16 359 129 8 16 369 129 8 16 359 129 8 16 349 129 8 16    867 354
3 397 97 10 14 414 97 10 14 431 97 10 14     6 379 129 8 16 349 129 8 16 359 129 8 16 369 129 8 16 359 129 8 16 349 129 8 16    883 354
3 397 97 10 14 414 97 10 14 431 97 10 14     6 379 129 8 16 349 129 8 16 359 129 8 16 369 129 8 16 359 129 8 16 349 129 8 16    899 354
3 397 97 10 14 414 97 10 14 431 97 10 14     6 379 129 8 16 349 129 8 16 359 129 8 16 369 129 8 16 359 129 8 16 349 129 8 16    915 354
3 397 97 10 14 414 97 10 14 431 97 10 14     6 379 129 8 16 349 129 8 16 359 129 8 16 369 129 8 16 359 129 8 16 349 129 8 16    931 354
3 397 97 10 14 414 97 10 14 431 97 10 14     6 379 129 8 16 349 129 8 16 359 129 8 16 369 129 8 16 359 129 8 16 349 129 8 16    835 386
3 397 97 10 14 414 97 10 14 431 97 10 14     6 379 129 8 16 349 129 8 16 359 129 8 16 369 129 8 16 359 129 8 16 349 129 8 16    851 386
3 397 97 10 14 414 97 10 14 431 97 10 14     6 379 129 8 16 349 129 8 16 359 129 8 16 369 129 8 16 359 129 8 16 349 129 8 16    867 386
3 397 97 10 14 414 97 10 14 431 97 10 14     6 379 129 8 16 349 129 8 16 359 129 8 16 369 129 8 16 359 129 8 16 349 129 8 16    883 386
3 397 97 10 14 414 97 10 14 431 97 10 14     6 379 129 8 16 349 129 8 16 359 129 8 16 369 129 8 16 359 129 8 16 349 129 8 16    899 386
3 397 97 10 14 414 97 10 14 431 97 10 14     6 379 129 8 16 349 129 8 16 359 129 8 16 369 129 8 16 359 129 8 16 349 129 8 16    915 386
3 397 97 10 14 414 97 10 14 431 97 10 14     6 379 129 8 16 349 129 8 16 359 129 8 16 369 129 8 16 359 129 8 16 349 129 8 16    931 386
QUESTION 15
1 380 460 16 16                              349 78 16 16       1504 144    9 COIN
1 380 460 16 16                              349 78 16 16       1616 144     1 STAR
3 298 78 16 16 315 78 16 16 332 78 16 16     349 78 16 16       336 144     1 POWER
3 298 78 16 16 315 78 16 16 332 78 16 16     349 78 16 16       256 144     1 COIN
3 298 78 16 16 315 78 16 16 332 78 16 16     349 78 16 16       368 144     1 COIN
3 298 78 16 16 315 78 16 16 332 78 16 16     349 78 16 16       352 80      1 COIN
3 298 78 16 16 315 78 16 16 332 78 16 16     349 78 16 16       1248 144      1 COIN
3 298 78 16 16 315 78 16 16 332 78 16 16     349 78 16 16       1504 80      1 COIN
3 298 78 16 16 315 78 16 16 332 78 16 16     349 78 16 16       1696 144      1 COIN
3 298 78 16 16 315 78 16 16 332 78 16 16     349 78 16 16       1744 144      1 COIN
3 298 78 16 16 315 78 16 16 332 78 16 16     349 78 16 16       1792 144      1 COIN
3 298 78 16 16 315 78 16 16 332 78 16 16     349 78 16 16       1744 80      1 POWER
3 298 78 16 16 315 78 16 16 332 78 16 16     349 78 16 16       2064 80      1 COIN
3 298 78 16 16 315 78 16 16 332 78 16 16     349 78 16 16       2080 80      1 COIN
3 298 78 16 16 315 78 16 16 332 78 16 16     349 78 16 16       2720 144      1 COIN
SEWER 6
119 196 32 16       119 213 32 16    448 176     32 0
119 196 32 16       119 213 32 16    608 160     48 0
119 196 32 16       119 213 32 16    736 144     64 0
119 196 32 16       119 213 32 16    912 144     64     1   797 272     768 240
119 196 32 16       119 213 32 16    2608 176     32 0
119 196 32 16       119 213 32 16    2864 176     32 0
H_SEWER 1
249 230 16 32       266 230 16 32    976 416     32      1   2616 176    2403 0       1
FLAG 1
388 405 17 17       143 247 2 16    3160 48     144

GOOMBA 16
350 190
640 190
810 190
835 190
1280 60
1310 60
1550 190
1575 190
1820 190
1845 190
1980 190
2005 190
2035 190
2060 190
2780 190
2805 190
KOOPA 1
1710 190
