2
BRICK 3
17 16 16 16     120 75 8 8      320 144
17 16 16 16     120 75 8 8      352 144
17 16 16 16     120 75 8 8      384 144
FLOOR 2
0 16 16 16      0 208   69
0 16 16 16      0 224   69
COIN 2
3 298 95 16 16 315 95 16 16 332 95 16 16    233 192     6 379 129 8 16 349 129 8 16 359 129 8 16 369 129 8 16 359 129 8 16 349 129 8 16
3 298 95 16 16 315 95 16 16 332 95 16 16    320 128     6 379 129 8 16 349 129 8 16 359 129 8 16 369 129 8 16 359 129 8 16 349 129 8 16